-	ー
'	っ
,	､
.	｡
[	「
]	」
`	w
a	あ
o	お
e	え
u	う
i	い
;	あん
q	おん
j	えん
k	うん
x	いん
c'	かい
c,	こう
c.	けい
cp	くう
cy	くい
cc	きゅう
cr	こと
ca	か
co	こ
ce	け
cu	く
ci	き
cs	きょう
c;	かん
cq	こん
cj	けん
ck	くん
cx	きん
s'	さい
s,	そう
s.	せい
sp	すう
sy	すい
sc	する
sa	さ
so	そ
se	せ
su	す
si	し
sd	した
st	しゅう
ss	しょう
s;	さん
sq	そん
sj	せん
sk	すん
sx	しん
sb	され
t'	たい
t,	とう
t.	てい
tp	つう
ty	つい
tg	とき
tc	ところ
tr	たり
ta	た
to	と
te	て
tu	つ
ti	ち
tt	ちゅう
ts	ちょう
t;	たん
tq	とん
tj	てん
tk	つん
tx	ちん
tb	ため
n'	ない
n,	のう
n.	ねい
np	ぬう
ny	ぬい
ng	なに
nc	なる
nr	なら
na	な
no	の
ne	ね
nu	ぬ
ni	に
nd	など
nt	にゅう
nn	ん
ns	にょう
n;	なん
nq	のん
nj	ねん
nk	ぬん
nx	にん
nb	ならば
nz	んっ
h'	はい
h,	ほう
h.	へい
hp	ふう
hy	ふい
hc	ひと
ha	は
ho	ほ
he	へ
hu	ふ
hi	ひ
hh	ほど
ht	ひゅー
hs	ひょう
h;	はん
hq	ほん
hj	へん
hk	ふん
hx	ひん
m'	まい
m,	もう
m.	めい
mp	むう
my	むい
mc	もの
ml	ます
ma	ま
mo	も
me	め
mu	む
mi	み
md	まで
mt	ミュー
ms	みょう
m;	まん
mq	もん
mj	めん
mk	むん
mx	みん
yy	いう
yf	ゆい
yg	ゆう
yc	ゆく
yr	よう
yl	やい
ya	やす
yd	よい
yh	ゆ
yt	イェ
yn	よ
ys	や
yb	ゆび
ym	ゆん
yw	いわれ
yv	よん
yz	やん
r'	らい
r,	ろう
r.	れい
rp	るう
ry	るい
rc	りゅう
rr	られ
ra	ら
ro	ろ
re	れ
ru	る
ri	り
rd	りつ
rs	りょう
r;	らん
rq	ろん
rj	れん
rk	るん
rx	りん
rb	れば
w'	わい
w,	うぉー
w.	うぇー
wp	うい
wy	うぃー
wa	わ
wo	を
we	ゑ
wu	う
wi	ゐ
w;	わん
wq	ウォン
wj	ゑん
wk	うん
wx	ゐん
g'	がい
g,	ごう
g.	げい
gp	ぐう
gy	ぐい
gg	ごと
gc	ぎゅう
ga	が
go	ご
ge	げ
gu	ぐ
gi	ぎ
gd	ぎつ
gs	ぎょう
g;	がん
gq	ごん
gj	げん
gk	ぐん
gx	ぎん
gb	げば
z'	ざい
z,	ぞう
z.	ぜい
zp	ずう
zy	ずい
za	ざ
zo	ぞ
ze	ぜ
zu	ず
zi	じ
zt	じゅう
zn	ざるをえ
z;	ざん
zq	ぞん
zj	ぜん
zk	ずん
zx	じん
zz	じょう
sr'	ざい
sr,	ぞう
sr.	ぜい
srp	ずう
sry	ずい
src	じゅう
srr	ざるをえ
sra	ざ
sro	ぞ
sre	ぜ
sru	ず
sri	じ
srs	じょう
sr;	ざん
srq	ぞん
srj	ぜん
srk	ずん
srx	じん
d'	だい
d,	どう
d.	でい
dp	づう
dy	づい
dc	どころ
da	だ
do	ど
de	で
du	づ
di	ぢ
d;	だん
dq	どん
dj	でん
dk	づん
dx	ぢん
b'	ばい
b,	ぼう
b.	べい
bp	ぶう
by	ぶい
ba	ば
bo	ぼ
be	べ
bu	ぶ
bi	び
bt	びゅう
bs	びょう
b;	ばん
bq	ぼん
bj	べん
bk	ぶん
bx	びん
p.	ぴゅう
pf	ぷい
pg	ぷう
pc	ぺい
pr	ぽう
pl	ぱい
pa	ぴょう
pd	ぴ
ph	ぷ
pt	ぺ
pn	ぽ
ps	ぱ
pb	ぴん
pm	ぷん
pw	ぺん
pv	ぽん
pz	ぱん
f'	ファイ
f,	フォー
f.	フェイ
fp	フュー
fy	フィー
fa	ファ
fo	フォ
fe	フェ
fu	フュ
fi	フィ
f;	ファン
fq	フォン
fj	フェン
fx	フィン
v'	ヴァイ
v,	ヴォー
v.	ヴェー
vp	ヴー
vy	ヴぃー
va	ヴァ
vo	ヴォ
ve	ヴェ
vu	ヴ
vi	ヴィ
v;	ヴァン
vq	ヴォン
vj	ヴェン
vk	ヴン
vx	ヴィン
vw	ヴュー
vv	おなじ
vz	ヴォー
l'	あい
l,	おう
l.	えい
lp	うい
ly	いい
lg	っつ
lc	っち
lr	っと
ll	った
la	ぁ
lo	ぉ
le	ぇ
lu	ぅ
li	ぃ
lh	って
l;	あっ
lq	おっ
lj	えっ
lk	うっ
lx	いっ
cg'	きゃい
cg,	きょう
cg.	きぇい
cgp	きゅう
cgy	きゅい
cgr	きょく
cga	きゃ
cgo	きょ
cge	きぇ
cgu	きゅ
cgi	きぃ
cgn	くち
cgs	きゃく
cg;	きゃん
cgq	きょん
cgj	きぇん
cgk	きゅん
cgx	きぃん
sh'	しゃい
sh,	しょう
sh.	しぇい
shp	しゅう
shy	しゅい
sha	しゃ
sho	しょ
she	しぇ
shu	しゅ
shi	しぃ
shh	しゅく
sht	しゅつ
shn	しょく
shs	しゃく
sh;	しゃん
shq	しょん
shj	しぇん
shk	しゅん
shx	しぃん
th'	ちゃい
th,	ちょう
th.	ちぇい
thp	ちゅう
thy	ちゅい
tha	ちゃ
tho	ちょ
the	ちぇ
thu	ちゅ
thi	ちぃ
thn	ちょく
ths	ちゃく
th;	ちゃん
thq	ちょん
thj	ちぇん
thk	ちゅん
thx	ちぃん
td,	とぅ
tdy	とぃ
tdr	とぅっ
tda	とぁ
tdo	てょ
tde	てぇ
tdu	てゅ
tdi	てぃ
tdt	てゅっ
tdn	てぃっ
tds	てぃっ
td;	とぁん
tdq	とぅん
tdk	とぅん
tdx	てぃん
tn'	つぁい
tn,	つぉう
tn.	つぇい
tnp	つぅう
tny	つぅい
tna	つぁ
tno	つぉ
tne	つぇ
tnu	つぅ
tni	つぃ
tn;	つぁん
tnq	つぉん
tnj	つぇん
tnk	つぅん
tnx	つぃん
nh'	にゃい
nh,	にょう
nh.	にぇい
nhp	にゅう
nhy	にゅい
nha	にゃ
nho	にょ
nhe	にぇ
nhu	にゅ
nhi	にぃ
nhn	にょく
nhs	にゃく
nh;	にゃん
nhq	にょん
nhj	にぇん
nhk	にゅん
nhx	にぃん
hn'	ひゃい
hn,	ひょう
hn.	ひぇい
hnp	ひゅう
hny	ひゅい
hna	ひゃ
hno	ひょ
hne	ひぇ
hnu	ひゅ
hni	ひぃ
hnt	はな
hns	ひゃく
hn;	ひゃん
hnq	ひょん
hnj	ひぇん
hnk	ひゅん
hnx	ひぃん
mn'	みゃい
mn,	みょう
mn.	みぇい
mnp	みゅう
mny	みゅい
mna	みゃ
mno	みょ
mne	みぇ
mnu	みゅ
mni	みぃ
mns	みゃく
mn;	みゃん
mnq	みょん
mnj	みぇん
mnk	みゅん
mnx	みぃん
rg'	りゃい
rg,	りょう
rg.	りぇい
rgp	りゅう
rgy	りゅい
rgr	りょく
rga	りゃ
rgo	りょ
rge	りぇ
rgu	りゅ
rgi	りぃ
rgs	りゃく
rg;	りゃん
rgq	りょん
rgj	りぇん
rgk	りゅん
rgx	りぃん
gr'	ぎゃい
gr,	ぎょう
gr.	ぎぇい
grp	ぎゅう
gry	ぎゅい
grc	ぎょく
gra	ぎゃ
gro	ぎょ
gre	ぎぇ
gru	ぎゅ
gri	ぎぃ
grs	ぎゃく
gr;	ぎゃん
grq	ぎょん
grj	ぎぇん
grk	ぎゅん
grx	ぎぃん
zh'	じゃい
zh,	じょう
zh.	じぇい
zhp	じゅう
zhy	じゅい
zha	じゃ
zho	じょ
zhe	じぇ
zhu	じゅ
zhi	じぃ
zhh	じゅく
zht	じゅつ
zhn	じょく
zh;	じゃん
zhq	じょん
zhj	じぇん
zhk	じゅん
zhx	じぃん
zhz	じゃく
sg'	じゃい
sg,	じょう
sg.	じぇい
sgp	じゅう
sgy	じゅい
sgg	じゅく
sgc	じゅつ
sgr	じょく
sga	じゃ
sgo	じょ
sge	じぇ
sgu	じゅ
sgi	じぃ
sgs	じゃく
sg;	じゃん
sgq	じょん
sgj	じぇん
sgk	じゅん
sgx	じぃん
dn'	ぢゃい
dn,	ぢょう
dn.	ぢぇい
dnp	ぢゅう
dny	ぢゅい
dna	ぢゃ
dno	ぢょ
dne	ぢぇ
dnu	ぢゅ
dni	ぢぃ
dn;	ぢゃん
dnq	ぢょん
dnj	ぢぇん
dnk	ぢゅん
dnx	ぢぃん
bn'	ぶら
bn,	ぶろ
bn.	ぶれ
bnp	ぶる
bny	ぶり
bna	びゃ
bno	びょ
bne	びぇ
bnu	びゅ
bni	びぃ
bns	びゃく
bn;	ぶらん
bnq	ぶろん
bnj	ぶれん
bnk	びゅん
bnx	びぃん
vh'	ヴぁり
vh,	ヴぉる
vh.	ヴぇる
vhp	ヴぁる
vhy	ヴぃる
vha	ヴゃ
vho	ヴょ
vhe	ヴぇ
vhu	ヴゅ
vhi	ヴぃ
vhv	ヴゃく
vhz	ヴゃく
p,f	ぷり
p,g	ぷる
p,c	ぷれ
p,r	ぷろ
p,l	ぷら
p,a	ぴゃく
p,d	ぴぃ
p,h	ぴゅ
p,t	ぴぇ
p,n	ぴょ
p,s	ぴゃ
p,b	ぷりん
p,m	ぴゅん
p,w	ぷれん
p,v	ぴょん
p,z	ぷらん
dt'	どぁ
dt,	どぅ
dt.	どぇ
dta	でゃ
dto	でょ
dte	でぇ
dtu	でゅ
dti	でぃ
dth	でゅっ
dtn	でぃっ
dtk	でゅん
dtx	でぃん
fr'	ふら
fr,	ふろ
fr.	ふれ
frp	ふる
fry	ふり
fra	ふゃ
fro	ふょ
fru	ふゅ
fr;	ふらっ
frq	ふろっ
frj	ふれっ
frk	ふるっ
frx	ふりっ
hma	ほぁ
hm;	ほぁん
ct,	くぉー
ct.	くぇー
cta	くゎ
cto	くぉ
cte	くぇ
ctu	くぅ
cti	くぃ
ct;	くゎん
ctq	くぉん
ctj	くぇん
ctk	くぅん
ctx	くぃん
gta	ぐゎ
gto	ぐぉ
gte	ぐぇ
gtu	ぐぅ
gti	ぐぃ
gt;	ぐゎん
gtq	ぐぉん
gtj	ぐぇん
gtk	ぐぅん
gtx	ぐぃん
wh'	うぁい
wh,	うぉう
wh.	うぇい
why	うぃー
wha	うぁ
who	うぉ
whe	うぇい
whu	うぅ
whi	うぃ
wh;	うぁん
whq	うぉん
whj	うぇん
whx	うぃん
ch'	かつ
ch,	こつ
ch.	けき
chp	くち
chy	きつ
chc	きゅっ
chr	きょっ
cha	かく
cho	こく
che	けつ
chu	くつ
chi	きく
cht	きぇっ
chs	きゃっ
ch;	かっ
chq	こっ
chj	けっ
chk	くっ
chx	きっ
sm'	さつ
sm,	そつ
sm.	せき
smp	すぎ
smy	しつ
smc	しぇっ
sma	さく
smo	そく
sme	せつ
smu	すく
smi	しき
smt	しゅっ
smn	しょっ
sms	しゃっ
sm;	さっ
smq	そっ
smj	せっ
smk	すっ
smx	しっ
tm'	たつ
tm,	とつ
tm.	てき
tmp	つぎ
tmy	ちつ
tmc	ちぇっ
tma	たく
tmo	とく
tme	てつ
tmu	つく
tmi	ちく
tmt	ちゅっ
tmn	ちょっ
tms	ちゃっ
tm;	たっ
tmq	とっ
tmj	てっ
tmk	つっ
tmx	ちっ
nm'	なつ
nm,	のち
nmy	にち
nmr	にぇっ
nma	なく
nmo	のく
nme	ねつ
nmu	ぬく
nmi	にく
nmt	にゅっ
nmn	にょっ
nms	にゃっ
nm;	なっ
nmq	のっ
nmj	ねっ
nmk	ぬっ
nmx	にっ
hr'	はつ
hr,	ほつ
hr.	へき
hrp	ふつ
hrg	ひぇっ
hrc	ひょっ
hra	はく
hro	ほく
hre	へつ
hru	ふく
hri	ひつ
hrh	ひゅっ
hrs	ひゃっ
hr;	はっ
hrq	ほっ
hrj	へっ
hrk	ふっ
hrx	ひっ
mr'	まつ
mr,	もつ
mrp	むつ
mrc	みょっ
mra	まく
mro	もく
mre	めつ
mru	むく
mri	みつ
mrs	みゃっ
mr;	まっ
mrq	もっ
mrj	めっ
mrk	むっ
mrx	みっ
mrm	みゅっ
rh'	らつ
rh,	ろつ
rh.	れき
rhy	りつ
rhc	りゅっ
rhr	りょっ
rha	らく
rho	ろく
rhe	れつ
rhu	るく
rhi	りく
rhs	りゃっ
rh;	らっ
rhq	ろっ
rhj	れっ
rhk	るっ
rhx	りっ
wm'	わら
wm,	わろ
wm.	われ
wmp	わる
wmy	わり
wma	わく
wmo	をも
wme	わたし
wmu	われわれ
wmi	ゐく
wm;	わっ
wmq	うぉっ
wmj	うぇっ
wmk	うっ
wmx	うぃっ
gn'	がつ
gn,	ごつ
gn.	げき
gny	ぎつ
gng	ぎゅっ
gnc	ぎょっ
gna	がく
gno	ごく
gne	げつ
gnu	ぐつ
gni	ぎく
gns	ぎゃっ
gn;	がっ
gnq	ごっ
gnj	げっ
gnk	ぐっ
gnx	ぎっ
zm'	ざつ
zm.	ぜき
zmy	じつ
zma	ざく
zmo	ぞく
zme	ぜつ
zmu	ずつ
zmi	じく
zmt	じぇっ
zm;	ざっ
zmq	ぞっ
zmj	ぜっ
zmk	ずっ
zmx	じっ
zmw	じゅっ
zmv	じょっ
zmz	じゃっ
dr'	だつ
dr.	でき
drc	ぢょっ
dra	だく
dro	どく
dre	でつ
dru	づく
drh	ぢゅっ
drt	ぢぇっ
drs	ぢゃっ
dr;	だっ
drq	どっ
drj	でっ
drk	づっ
drx	ぢっ
br'	ばつ
br,	ぼつ
brc	びゅっ
bra	ばく
bro	ぼく
bre	べつ
bru	ぶつ
bri	びつ
brs	びゃっ
br;	ばっ
brq	ぼっ
brj	べっ
brk	ぶっ
brx	びっ
pop	ぴゅっ
pog	ぷつ
pol	ぱつ
poa	ぴゃっ
pod	ぴつ
poh	ぷく
pot	ぺつ
pon	ぽく
pos	ぱく
pob	ぴっ
pom	ぷっ
pow	ぺっ
pov	ぽっ
poz	ぱっ
vm'	ヴぁす
vm,	ヴぉす
vm.	ヴぇく
vmy	ヴぃす
vma	ヴぁく
vmo	ヴぉく
vme	ヴぇす
vmu	ヴゅー
vmi	ヴぃく
vm;	ヴぁっ
vmq	ヴぉっ
vmj	ヴぇっ
vmk	ヴっ
vmx	ヴぃっ
yol	やつ
yoa	やあ
yod	ゆき
yoh	ゆく
yot	やけ
yon	よく
yos	やく
yom	ゆっ
yov	よっ
yoz	やっ
fn'	ふぁす
fn,	ふぉと
fn.	ふぇく
fny	ふぃす
fna	ふぁく
fno	ふぉす
fne	ふぇす
fni	ふぃく
fn;	ふぁっ
fnq	ふぉっ
fnj	ふぇっ
fnk	ふゅっ
fnx	ふぃっ
y,p	やっぱり
y,f	より
y,g	よる
y,c	よれ
y,r	よろ
y,l	よら
y,a	やすい
y,h	やはり
y,t	やって
y,n	やっと
y,s	やった
y,b	よれば
y,m	やま
